XXXXXXXXXXXXXXXXXXXXX
    X   X   X X     X
XXX X XXXXX X XXX X X
X X     X         X X
X X X X XXX X XXXXX X
X X X X     X X X X X
X XXX XXX X XXX X X X
X     X X X   X     X
XXX XXX XXXXX X XXX X
X         X   X X    
XXXXXXXXXXXXXXXXXXXXX
