XXXXXXXXXXXXXXXXXXXXXXXXXXXXXXXXXXXXXXXXX
          X       X   X   X     X     X X
XXX XXX X XXX XXX X XXX X XXX XXX XXXXX X
X   X   X     X X     X X X   X   X     X
X XXXXX X XXXXX XXXXX X XXXXX X X X XXX X
X   X X X X       X X X       X X X   X X
X XXX XXXXX X X XXX X XXX XXX XXX X XXXXX
X   X X   X X X   X X   X   X     X   X X
X X X X X XXXXX XXX XXX X XXXXX X X XXX X
X X X X X   X     X         X X X X     X
X X X X XXXXXXX X XXXXXXXXX X XXXXXXXXX X
X X X X         X X   X         X       X
XXXXX XXXXX XXXXX X XXX XXXXX X X X XXXXX
X X     X     X     X   X   X X   X   X X
X X X X X XXXXXXXXX X XXXXX X X XXXXX X X
X   X X     X X   X   X   X   X X X     X
XXXXXXXXXXX X X X XXX XXX XXXXX X XXX X X
X   X         X X             X   X   X X
XXX X XXXXXXXXXXX XXXXX X XXX X XXXXXXX X
X         X         X   X   X X       X  
XXXXXXXXXXXXXXXXXXXXXXXXXXXXXXXXXXXXXXXXX
