XXXXXXXXXXXXXXX
  X         X X
X XXX XXX XXX X
X X   X       X
X XXXXXXX XXX X
X X       X   X
X X X X X X XXX
X   X X X X   X
X XXX XXX XXX X
X X   X   X   X
X XXXXX XXXXX X
X   X     X X X
XXX XXX X X X X
X   X   X X    
XXXXXXXXXXXXXXX
